-------------------------------------------------------------------------------------------------------------------------------------------------------------------------------------------------------------------------<----------------------------------------------------------------------------------------------------------------------------------------------------------
-?---------------<-----------------------?-------------------<-------------<-----?---------------<<<-------------<---------------<<--------------------------------------?-------------<--------------------------<<---?--------------------------------------------??---------------------<-------------------------?--------------------------------------------------------------
------------?-----------------?-??--------------?------------<----------<<-----------------------<------------------------<---?------------??--------------------<-------?---------------------?-------------------<---------------------------------------??-------?-----------------------------------<--<----------------------------?----?-----?---<------------------?---------
--------<<------------------<-------------------??-------?---<---------------------------?-------<---?----------------<<--<---?---<------?--------------------------------<--------------?-<---??-----<<-----------<-----------------------<-------------------<----------------------------------------------------------------<<----------------------------------------?-------?-
-----------<------<------------<--------?-?----------<-------<------??---------------------------<------<-------?-?---<-----------<--<--------------<-<---??-?--------????------?-----?--?-----?------------??---<-<-----------------------------------------------?----------------------------?-???------------------------?-----------------<-<-------------------?------<-<-----
---------------?---------------<-------------------------------------------------<-------?-----------------------------------?--------------<<----------------------------------------??-?----------?--<<---?----<-------------------------------------------------?------------------------------------<-------??------------------------------------------------------------<<----
--------------------------?----<-----------<----------------------------?---------------------?----------?----<------?----?--?------------<<-----------------------<---?--<<---??----?----------------------?------------------------------<<-------??----------------------------?--------------<<-------------?--------------------------?------------<---------------------------
-?-----------------<------------?----------------------<-<---------------?-------------------------------?-----------?---------------------------------------------<----------------------------<--------?--?---------------------------------------?-----------------------------?-----------------?----------------------------?--------------------------------------------------
----?-?-<----?-----<--------------<-------------------------------------<------------<-------------------?----------------------------------------------<<----------------<<--------?------------------<--<--<-----------------------<<-------------?---<---?------------?------------------------<-----<------------<-----<--<----<---------<---------------------------??-?-------
----???--------------?-------------------------?---------------------------------?-----------------------?-----------------<-----------------?--------------??----------------?--------------------------?-------?------------------------------<<--??------------------??-----?-?--?----?---------------?-----------------<-----?---------------?---------------<-------?-------?--
---------------------------------------?-------------------------<---?------?-------------------------------------------------?----<--<------?----?-?------------------------------------------------------------------------------------------?-------<----------------?----?----------------<-------?---------------------------------------------------------------------?----?--
-----?-------?-----------??------------?-------------------------<-------------------<---?---?----------------------------------------------??---?-------------------?-----------------------?-----------------------------?----------------------------------------------------------------------------------------------?------------------------<<---------------------<------?--
-------------------??--------<-------------<-----?--------<------<--<-<--------------<-<--------<<-----------?-----????---------------<<<--------?------------------?-----------?-??--------??--------------------------?-------??-------?--------------------?--?----<------?----<--------<<-<------------<------------------------??----???---------------------?---<-------------
-??--------?-------?-----?---<----------------------?-----------------------?------------?---------??--------??----?-------??---??-------------------------------?--?----??----------?-------?-------<------------------?--------?--?--------------------?-------?---<<-----------<-<------------------?---<--<---?---------?------???--<--------------?---------??-----?-----?-?---
--------------?------<---?---<---?---<---------------------------------------------?----------?---------------------------------?-----------------<------------<-----------------<-----<--------??---<-------------<--------------------<--------------<--------------------------<---------------?-------------<--------?------------------?-<<<-----------------------------------
------------------------------------------------------------------------------------------------------------------------------------------------------------------------------------------------------------------------------------------------------------------------------------------------------------------------------------------------------------------------------------
